TTTTTTTTTTT
T    T    T
T RRRT   RT
T    T    T
TT TTTT R T
T  R      T
T U  T  U T
T   RT    T
TTTTTTTTT T
TU        T
TTT   TTTTT
T   R T   T
T     T T T
T   RT  T T
T RU   TT T
T    RRP  T
TTTTTTTTTTT